S ./textures/pillar.xpm
R 800 600

H ./textures/health.xpm

NO ./textures/north.xpm
SO ./textures/south.xpm      
WE ./textures/west.xpm
EA 	./textures/east.xpm


F	128,128,128	
C	0,255,255		
  
		

 

1 1 1 1 1 1 1 1 1 1 1 1 1 1 1
1 0 0 0 0 0 W 0 0 0 0 0 0 0 1
1 0 0 0 0 0 0 0 0 0 0 0 0 0 1
1 0 0 1 0 0 0 0 0 1 0 0 0 0 1
1 0 0 0 0 0 0 0 0 0 0 0 0 0 1
1 0 0 1 0 0 0 0 0 1 0 0 0 0 1
1 0 0 0 0 2 0 2 0 0 0 0 0 0 1
1 0 0 0 0 0 0 0 0 0 0 0 0 0 1
1 1 1 1 1 1 1 1 1 1 1 1 1 1 1


